{
  "X000007788": "X000007788",
  "X000010126": "X000010126",
  "X000009974": "X000009974",
  "X000006774": "X000006774",
  "X000009385": "X000009385",
  "X000009319": "X000009319",
  "X000009959": "X000009959",
  "X000006628": "X000006628",
  "X000009975": "X000009975",
  "X000010550": "X000010550",
  "X000010026": "X000010026",
  "X000010037": "X000010037",
  "X000009947": "X000009947",
  "X000009714": "X000009714",
  "X000009979": "X000009979",
  "X000009904": "X000009904",
  "X000009943": "X000009943",
  "X000009726": "X000009726",
  "X000009653": "X000009653",
  "X000009879": "X000009879",
  "X000007663": "X000007663",
  "X000007733": "X000007733",
  "X000008444": "X000008444",
  "X000009116": "X000009116",
  "X000005672": "X000005672",
  "X000007149": "X000007149",
  "X000009720": "X000009720",
  "X000010537": "X000010537",
  "X000007791": "X000007791",
  "X000009320": "X000009320",
  "X000009908": "X000009908",
  "X000009878": "X000009878",
  "X000010536": "X000010536",
  "X000010585": "X000010585",
  "X000006860": "X000006860",
  "X000007226": "X000007226",
  "X000009559": "X000009559",
  "X000009141": "X000009141",
  "X000010510": "X000010510",
  "X000010361": "X000010361",
  "X000009523": "X000009523",
  "X000007660": "X000007660",
  "X000007729": "X000007729",
  "X000009538": "X000009538",
  "X000009537": "X000009537",
  "X000006454": "X000006454",
  "X000009890": "X000009890",
  "X000007555": "X000007555",
  "X000009905": "X000009905",
  "X000010019": "X000010019",
  "X000009122": "X000009122",
  "X000009903": "X000009903",
  "X000008924": "X000008924",
  "X000007659": "X000007659",
  "X000010360": "X000010360",
  "X000009556": "X000009556",
  "X000009926": "X000009926",
  "X000009910": "X000009910",
  "X000010543": "X000010543",
  "X000007744": "X000007744",
  "X000009418": "X000009418",
  "X000007740": "X000007740",
  "X000009527": "X000009527",
  "X000009602": "X000009602",
  "X000010256": "X000010256",
  "X000009569": "X000009569",
  "X000009536": "X000009536",
  "X000008447": "X000008447",
  "X000009570": "X000009570",
  "X000009557": "X000009557",
  "X000010040": "X000010040",
  "X000009722": "X000009722",
  "X000009535": "X000009535",
  "X000008446": "X000008446",
  "X000009251": "X000009251",
  "X000008928": "X000008928",
  "X000009156": "X000009156",
  "X000009165": "X000009165",
  "X000009528": "X000009528",
  "X000010551": "X000010551",
  "X000008454": "X000008454",
  "X000007743": "X000007743",
  "X000009560": "X000009560",
  "X000010029": "X000010029",
  "X000009019": "X000009019",
  "X000009719": "X000009719",
  "X000009718": "X000009718",
  "X000009532": "X000009316",
  "X000009316": "X000009316",
  "X000006958": "X000006958",
  "X000007014": "X000007014",
  "X000007795": "X000007795",
  "X000007850": "X000007850",
  "X000006198": "X000006198",
  "X000007653": "X000007653",
  "X000009772": "X000009772",
  "X000007299": "X000007299",
  "X000007358": "X000007358",
  "X000009113": "X000009113",
  "X000007153": "X000007153",
  "X000009125": "X000009125",
  "X000007141": "X000007141",
  "X000010088": "X000010088",
  "X000007256": "X000007256",
  "X000009472": "X000009472",
  "X000007212": "X000007212",
  "X000009473": "X000009473",
  "X000009868": "X000009868",
  "X000010584": "X000010584",
  "X000006328": "X000006328",
  "X000006279": "X000006279",
  "X000009855": "X000009855",
  "X000009978": "X000009978",
  "X000010089": "X000010089",
  "X000008206": "X000008206",
  "X000009520": "X000009520",
  "X000009637": "X000009637",
  "X000010558": "X000010558",
  "X000009127": "X000009127",
  "X000008532": "X000008532",
  "X000009858": "X000009858",
  "X000010031": "X000010031",
  "X000009961": "X000009961",
  "X000007654": "X000007654",
  "X000007797": "X000007797",
  "X000008531": "X000008531",
  "X000009045": "X000009045",
  "X000007420": "X000007420",
  "X000010257": "X000010257",
  "X000009515": "X000009515",
  "X000009495": "X000009495",
  "X000006460": "X000006460",
  "X000009289": "X000009289",
  "X000009645": "X000009645",
  "X000007308": "X000009645",
  "X000010540": "X000010540",
  "X000006347": "X000006347",
  "X000008535": "X000008535",
  "X000009315": "X000009315",
  "X000009469": "X000009469",
  "X000009507": "X000009507",
  "X000007334": "X000007334",
  "X000009505": "X000009505",
  "X000009065": "X000009065",
  "X000008068": "X000008068",
  "X000009680": "X000009680",
  "X000010559": "X000010559",
  "X000007556": "X000007556",
  "X000009865": "X000009865",
  "X000010539": "X000010539",
  "X000010258": "X000010258",
  "X000007688": "X000007688",
  "X000009674": "X000009674",
  "X000009856": "X000009856",
  "X000009861": "X000009861",
  "X000009958": "X000009958",
  "X000010087": "X000007692",
  "X000007692": "X000007692",
  "X000005677": "X000005677",
  "X000010367": "X000009028",
  "X000009028": "X000009028",
  "X000010259": "X000010259",
  "X000009869": "X000009869",
  "X000009970": "X000009970",
  "X000007711": "X000007711",
  "X000009524": "X000009524",
  "X000009492": "X000009492",
  "X000009046": "X000009046",
  "X000006443": "X000006443",
  "X000010538": "X000010538",
  "X000009949": "X000009949",
  "X000009053": "X000009053",
  "X000008471": "X000008471",
  "X000009851": "X000008516",
  "X000008516": "X000008516",
  "X000010512": "X000010512",
  "X000009097": "X000009097",
  "X000009210": "X000009210",
  "X000010093": "X000010086",
  "X000010086": "X000010086",
  "X000009605": "X000009605",
  "X000007689": "X000007069",
  "X000007069": "X000007069",
  "X000009915": "X000007069"
}